// Rott

Actor MultiLowGuard : LowGuard {+THRUSPECIES}
Actor MultiLowGuard_Boo : LowGuard_Boo {+THRUSPECIES}
Actor MultiLightningGuard : LightningGuard {+THRUSPECIES}
Actor MultiHeavyGuard : HeavyGuard {+THRUSPECIES}
Actor MultiHighGuard : HighGuard {+THRUSPECIES}
Actor MultiOverPatrol : OverPatrol {+THRUSPECIES}
Actor MultiStrikeTeam : StrikeTeam {+THRUSPECIES}
Actor MultiMonkDrain : MonkDrain {+THRUSPECIES}
Actor MultiMonkDeathFire : MonkDeathFire {+THRUSPECIES}
Actor MultiTriadEnforcer : TriadEnforcer {+THRUSPECIES}
Actor MultiExplosiveDiskJr : ExplosiveDiskJr {+THRUSPECIES}
Actor MultiExplosiveDiskSr : ExplosiveDiskSr {+THRUSPECIES}
Actor MultiCopterPatrol : CopterPatrol {+THRUSPECIES}
Actor MultiCopterPatrol2 : CopterPatrol2 {+THRUSPECIES}
Actor MultiRobotGuard : RobotGuard {+THRUSPECIES}
Actor MultiBallistikraft : Ballistikraft {+THRUSPECIES}
Actor MultiGeneralDarian : GeneralDarian {+THRUSPECIES}
Actor MultiSebastianKrist : SebastianKrist {+THRUSPECIES}
Actor MultiNME : NME {+THRUSPECIES}
Actor MultiTomHall : TomHall {+THRUSPECIES}
Actor MultiSnakeTom : SnakeTom {+THRUSPECIES}

//Strife

Actor MultiStrifeAcolyte : StrifeAcolyte {+THRUSPECIES Species "Enemies"}
Actor MultiStrifeAcolyte2 : StrifeAcolyte2 {+THRUSPECIES Species "Enemies"}
Actor MultiStrifeAcolyte3 : StrifeAcolyte3 {+THRUSPECIES Species "Enemies"}
Actor MultiStrifeAcolyte4 : StrifeAcolyte4 {+THRUSPECIES Species "Enemies"}
Actor MultiStrifeAcolyte5 : StrifeAcolyte5 {+THRUSPECIES Species "Enemies"}
Actor MultiStrifeAcolyte6 : StrifeAcolyte6 {+THRUSPECIES Species "Enemies"}
Actor MultiStrifeAcolyte7 : StrifeAcolyte7 {+THRUSPECIES Species "Enemies"}
Actor MultiStrifeAcolyte8 : StrifeAcolyte8 {+THRUSPECIES Species "Enemies"}
Actor MultiStrifeSentinel : StrifeSentinel {+THRUSPECIES Species "Enemies"}
Actor MultiStrifeStalker : StrifeStalker {+THRUSPECIES Species "Enemies"}
Actor MultiStrifeStalkerCeiling : StrifeStalkerCeiling {+THRUSPECIES Species "Enemies"}
Actor MultiShadowStalker : ShadowStalker {+THRUSPECIES Species "Enemies"}
Actor MultiShadowStalkerCeiling : StrifeStalkerCeiling {+THRUSPECIES Species "Enemies"}
Actor MultiStrifeReaver : StrifeReaver {+THRUSPECIES Species "Enemies"}
Actor MultiStrifeTemplar : StrifeTemplar {+THRUSPECIES Species "Enemies"}
Actor MultiStrifeCrusader : StrifeCrusader {+THRUSPECIES Species "Enemies"}
Actor MultiNewStrifeBishop : NewStrifeBishop {+THRUSPECIES Species "Enemies"}
Actor MultiRecycler : Recycler {+THRUSPECIES Species "Enemies"}
Actor MultiStrifeLoreMaster : StrifeLoreMaster {+THRUSPECIES Species "Enemies"}
Actor MultiNewMacil : NewMacil {+THRUSPECIES Species "Enemies"}
Actor MultiProgrammer : Programmer3 {+THRUSPECIES Species "Enemies"}
Actor MultiStrifeInquisitor : StrifeInquisitor {+THRUSPECIES Species "Enemies"}
Actor MultiNewAlienSpectre1 : NewAlienSpectre1 {+THRUSPECIES Species "Enemies"}
Actor MultiNewAlienSpectre2 : NewAlienSpectre2 {+THRUSPECIES Species "Enemies"}
Actor MultiNewAlienSpectre3 : NewAlienSpectre3 {+THRUSPECIES Species "Enemies"}
Actor MultiNewAlienSpectre4 : NewAlienSpectre4 {+THRUSPECIES Species "Enemies"}
Actor MultiNewAlienSpectre5 : NewAlienSpectre5 {Species "Enemies" +THRUSPECIES}
Actor MultiEntityNest : EntityNest_New {Species "Enemies" +THRUSPECIES}
Actor MultiStrifeEntity : StrifeEntity { Species "Enemies" +THRUSPECIES}

//Shadow Warrior

Actor MultiSWNinja : SWNinja {+THRUSPECIES}
Actor MultiNinjaRed : NinjaRed {+THRUSPECIES}
Actor MultiNinjaOrange : NinjaOrange {+THRUSPECIES}
Actor MultiNinjaGray: NinjaGray {+THRUSPECIES}
Actor MultiNinjaDark : NinjaDark {+THRUSPECIES}
Actor MultiSWHenchman : SWHenchman {+THRUSPECIES}
Actor MultiSWHenchmanRed : SWHenchmanRed {+THRUSPECIES}
Actor MultiSWHenchmanGreen : SWHenchmanGreen {+THRUSPECIES}
Actor MultiSWHenchmanPurple : SWHenchmanPurple {+THRUSPECIES}
Actor MultiSWHenchmanOrange : SWHenchmanOrange {+THRUSPECIES}
Actor MultiSWRipperBaby: SWRipperBaby {+THRUSPECIES}
Actor MultiSWRipperBabyBig: SWRipperBabyBig {+THRUSPECIES}
Actor MultiCoolieGhost : CoolieGhost {+THRUSPECIES}
Actor MultiSWWizard : SWWizard {+THRUSPECIES}
Actor MultiSWAssassin : SWAssassin {+THRUSPECIES}
Actor MultiCoolie : Coolie {+THRUSPECIES}
Actor MultiSWRipper: SWRipper {+THRUSPECIES}
Actor MultiSWRipperBig: SWRipperBig {+THRUSPECIES}
Actor MultiGuardian : Guardian {+THRUSPECIES}
Actor MultiSerpentGod : SerpentGod {+THRUSPECIES}
Actor MultiSerpentGodBig : SerpentGodBig {+THRUSPECIES}
Actor MultiSumoBig : SumoBig {+THRUSPECIES}
Actor MultiSumoSmall : SumoSmall {+THRUSPECIES}
Actor MultiMasterZilla : MasterZilla {+THRUSPECIES}
Actor MultiLoWangBrother : LoWangBrother {+THRUSPECIES}
Actor MultiSWRabbit : SWRabbit { +THRUSPECIES}
Actor MultiSWWizardGray : SWWizardGray {+THRUSPECIES}
Actor MultiSWWizardRed : SWWizardRed {+THRUSPECIES}

//Redneck Rampage

Actor MultiOldSkinnyCoot : OldSkinnyCoot {+THRUSPECIES}
Actor MultiBlueGroovyOldCoot : BlueGroovyOldCoot {+THRUSPECIES}
Actor MultiBrownGroovyOldCoot : BrownGroovyOldCoot {+THRUSPECIES}
Actor MultiRedPantsGroovyOldCoot : RedPantsGroovyOldCoot {+THRUSPECIES}
Actor MultiRedGroovyOldCoot : RedGroovyOldCoot {+THRUSPECIES}
Actor MultiGreenGroovyOldCoot : GreenGroovyOldCoot {+THRUSPECIES}
Actor MultiWhiteGroovyOldCoot : WhiteGroovyOldCoot {+THRUSPECIES}
Actor MultiBillyRayJeeter : BillyRayJeeter {+THRUSPECIES}
Actor MultiBlueFrankDoyle : BlueFrankDoyle {+THRUSPECIES}
Actor MultiRedFrankDoyle : RedFrankDoyle {+THRUSPECIES}
Actor MultiBlackFrankDoyle : BlackFrankDoyle {+THRUSPECIES}
Actor MultiGreenFrankDoyle : GreenFrankDoyle {+THRUSPECIES}
Actor MultiBrownFrankDoyle : BrownFrankDoyle {+THRUSPECIES}
Actor MultiBlueFrankDoyle_Type2 : BlueFrankDoyle_Type2 {+THRUSPECIES}
Actor MultiRedFrankDoyle_Type2 : RedFrankDoyle_Type2 {+THRUSPECIES}
Actor MultiBlackFrankDoyle_Type2 : BlackFrankDoyle_Type2 {+THRUSPECIES}
Actor MultiGreenFrankDoyle_Type2 : GreenFrankDoyle_Type2 {+THRUSPECIES}
Actor MultiBrownFrankDoyle_Type2 : BrownFrankDoyle_Type2 {+THRUSPECIES}
Actor MultiTurdSwampMinion : TurdSwampMinion {+THRUSPECIES}
Actor MultiTurdLavaMinion : TurdLavaMinion {+THRUSPECIES}
Actor MultiRedDaisyMae : RedDaisyMae {+THRUSPECIES}
Actor MultiGreenDaisyMae : GreenDaisyMae {+THRUSPECIES}
Actor MultiDarkDaisyMae : DarkDaisyMae {+THRUSPECIES}
Actor MultiPartiDaisyMae : PartiDaisyMae {+THRUSPECIES}
Actor MultiDaisyNDoylie : DaisyNDoylie {+THRUSPECIES}
Actor MultiGuardDog : GuardDog {+THRUSPECIES}
Actor MultiTurdUFO : TurdUFO {+THRUSPECIES}
Actor MultiChickenUFO : ChickenUFO {+THRUSPECIES}
Actor MultiCootUFO : CootUFO {+THRUSPECIES}
Actor MultiDogUFO : DogUFO {+THRUSPECIES}
Actor MultiPigUFO : PigUFO {+THRUSPECIES}
Actor MultiBillyRayUFO : BillyRayUFO {+THRUSPECIES}
Actor MultiDoyleBike : DoyleBike {+THRUSPECIES}
Actor MultiDoyleDaisyBike : DoyleDaisyBike {+THRUSPECIES}
Actor MultiMosquito : Mosquito {+THRUSPECIES}
Actor MultiSheriffHobbes : SheriffHobbes {+THRUSPECIES}
Actor MultiAlienHulk : AlienHulk {+THRUSPECIES}
Actor MultiKingHulk : KingHulk {+THRUSPECIES}
Actor MultiJackelope : Jackelope {+THRUSPECIES}
Actor MultiAlligator : Alligator {+THRUSPECIES}
Actor MultiBigJackelope : BigJackelope {+THRUSPECIES}
Actor MultiBlueVixen : BlueVixen {+THRUSPECIES}
Actor MultiRedVixen : RedVixen {+THRUSPECIES}
Actor MultiGreenVixen : GreenVixen {+THRUSPECIES}
Actor MultiBrownVixen : BrownVixen {+THRUSPECIES}
Actor MultiQueenVixen : QueenVixen {+THRUSPECIES}
Actor MultiAssface : Assface {+THRUSPECIES}
Actor MultiRedneckUFO : RandomSpawner { DropItem "MultiTurdUFO" DropItem "MultiChickenUFO" DropItem "MultiCootUFO" DropItem "MultiDogUFO" DropItem "MultiPigUFO" DropItem "MultiBillyRayUFO" }
Actor MultiAlienVixenSpawner : RandomSpawner { DropItem "MultiBlueVixen" DropItem "MultiRedVixen" DropItem "MultiGreenVixen" DropItem "MultiBrownVixen" }
Actor MultiDaisyMae : RandomSpawner { DropItem "MultiRedDaisyMae" DropItem "MultiGreenDaisyMae" DropItem "MultiDarkDaisyMae" DropItem "MultiPartiDaisyMae" }
Actor MultiSkinnyOldCoot : RandomSpawner { DropItem "MultiOldSkinnyCoot" DropItem "MultiBlueGroovyOldCoot" DropItem "MultiBrownGroovyOldCoot" DropItem "MultiOldSkinnyCoot" DropItem "MultiRedPantsGroovyOldCoot" DropItem "MultiRedGroovyOldCoot" DropItem "MultiGreenGroovyOldCoot" DropItem "MultiOldSkinnyCoot" DropItem "MultiWhiteGroovyOldCoot" }
Actor MultiFrankDoyle : RandomSpawner { DropItem "MultiBlueFrankDoyle" DropItem "MultiRedFrankDoyle" DropItem "MultiBlackFrankDoyle" DropItem "MultiGreenFrankDoyle" DropItem "MultiBrownFrankDoyle" DropItem "MultiBlueFrankDoyle_Type2" DropItem "MultiRedFrankDoyle_Type2" DropItem "MultiBlackFrankDoyle_Type2" DropItem "MultiGreenFrankDoyle_Type2" DropItem "MultiBrownFrankDoyle_Type2" }
Actor MultiTurdMinionSpawner_SPF : RandomSpawner { DropItem "MultiTurdMinion" DropItem "MultiTurdSwampMinion" DropItem "MultiTurdLavaMinion" }

//Chex Quest

ACTOR MultiNewFlemoidusGyro : NewFlemoidusGyro {Species "NewFlemoidusGyro" +THRUSPECIES}
ACTOR MultiFlemoidusGyro : FlemoidusGyro {Species "FlemoidusGyro" +THRUSPECIES}

// Dark Forces

ACTOR Multistorm_trooper : storm_trooper {+THRUSPECIES}
ACTOR Multihoth_trooper : hoth_trooper {+THRUSPECIES}
ACTOR MultiDF_officer : DF_officer {+THRUSPECIES}
ACTOR Multiimperial_commander : imperial_commander {+THRUSPECIES}
ACTOR Multigamorrean_guard : gamorrean_guard {+THRUSPECIES}
ACTOR Multitrandoshan_1 : trandoshan_1 {+THRUSPECIES}
ACTOR Multigran___DF : gran___DF {+THRUSPECIES}
ACTOR Multiinterrogation_droid : interrogation_droid {+THRUSPECIES}
ACTOR Multiprobe_droid : probe_droid {+THRUSPECIES}
ACTOR Multiboba_fett : boba_fett {+THRUSPECIES}
ACTOR MultiKellDragon : KellDragon {+THRUSPECIES}
ACTOR Multiphase1_DF : phase1_DF {+THRUSPECIES}
ACTOR Multiphase2_DF : phase2_DF {+THRUSPECIES}
ACTOR Multiphase3_DF : phase3_DF {+THRUSPECIES}
ACTOR Multijerec : jerec {+THRUSPECIES}
ACTOR MultiDFRemote : DFRemote {+THRUSPECIES}

// Eradicator

ACTOR MultiHSD : HSD {+THRUSPECIES}
ACTOR MultiHSD2 : HSD2 {+THRUSPECIES}
ACTOR MultiLSD : LSD {+THRUSPECIES}
ACTOR MultiLSD2 : LSD2 {+THRUSPECIES}
ACTOR MultiGorBoss : GorBoss {+THRUSPECIES}
ACTOR MultiGunTurret1 : GunTurret1 {+THRUSPECIES}
ACTOR MultiGunTurret2 : GunTurret2 {+THRUSPECIES}
ACTOR MultiPatrolEyeSpawner : PatrolEyeSpawner {+THRUSPECIES}
ACTOR MultiMiniBio : MiniBio {+THRUSPECIES}
ACTOR MultiEradArcher : EradArcher {+THRUSPECIES}
ACTOR MultiMiniRepairDroid : MiniRepairDroid {+THRUSPECIES}
ACTOR MultiRepairDroid : RepairDroid {+THRUSPECIES}
ACTOR MultiSkaal : Skaal {+THRUSPECIES}
ACTOR MultiRotoDroid : RotoDroid {+THRUSPECIES}
ACTOR MultiSkeeving : Skeeving {+THRUSPECIES}
ACTOR MultiBoonBitter : BoonBitter {+THRUSPECIES}
ACTOR MultiRSA : RSA {+THRUSPECIES}
ACTOR MultiEradMindBreaker : EradMindBreaker {+THRUSPECIES}
ACTOR MultiMiniMech : MiniMech {+THRUSPECIES}

// Cybermage

ACTOR MultiCMTrooper : CMTrooper {+THRUSPECIES}
ACTOR MultiCMDrone : CMDrone {+THRUSPECIES}
ACTOR MultiCMDrone_2 : CMDrone_2 {+THRUSPECIES}
ACTOR MultiMetacop : Metacop {+THRUSPECIES}
ACTOR MultiCMSlugg : CMSlugg {+THRUSPECIES}
ACTOR MultiGhoulie : Ghoulie {+THRUSPECIES}
ACTOR MultiMetabot : Metabot {+THRUSPECIES}
ACTOR MultiGangerMale : GangerMale {+THRUSPECIES}
ACTOR MultiGangerFemale : GangerFemale {+THRUSPECIES}
ACTOR MultiCMMongo : CMMongo {+THRUSPECIES}
ACTOR MultiCMLoD : CMLoD {+THRUSPECIES}
ACTOR MultiCMStynx : CMStynx {+THRUSPECIES}
ACTOR MultiCMGenno : CMGenno {+THRUSPECIES}
ACTOR MultiCMMung : CMMung {+THRUSPECIES}
ACTOR MultiCMCultie : CMCultie {+THRUSPECIES}
ACTOR MultiCMGangX : CMGangX {+THRUSPECIES}
ACTOR MultiSrifeng : Srifeng {+THRUSPECIES}
ACTOR MultiCMDragonbat : CMDragonbat {+THRUSPECIES}
ACTOR MultiCMHellspider : CMHellspider {+THRUSPECIES}
ACTOR MultiWildMung : WildMung {+THRUSPECIES}
ACTOR MultiExceptionalMung : ExceptionalMung {+THRUSPECIES}
ACTOR MultiPoweredGhoulie : PoweredGhoulie {+THRUSPECIES}
ACTOR MultiCMTank : CMTank {+THRUSPECIES}
ACTOR MultiCMAircar : CMAircar {+THRUSPECIES}
ACTOR MultiFiremother : Firemother {+THRUSPECIES}
ACTOR MultiNeCrom : NeCrom {+THRUSPECIES}

// Corridor 7

ACTOR MultiAiloprobe : Ailoprobe {+THRUSPECIES}
Actor MultiSectorProbe : C7SectorProbe {+THRUSPECIES}
ACTOR MultiAnimatedProbe : AnimatedProbe {+THRUSPECIES}
ACTOR MultiAiloprobe_2 : Ailoprobe_2 {+THRUSPECIES}
ACTOR MultiAnimatedProbe_2 : AnimatedProbe_2 {+THRUSPECIES}
ACTOR MultiSolrac : Solrac {+THRUSPECIES}
ACTOR MultiTtocs : Ttocs {+THRUSPECIES}
ACTOR MultiOtrebor : Otrebor {+THRUSPECIES}
ACTOR MultiC7MWarrior : C7MWarrior {+THRUSPECIES}
ACTOR MultiRodex : Rodex {+THRUSPECIES}
ACTOR MultiBandor : Bandor {+THRUSPECIES}
ACTOR MultiEitak : Eitak {+THRUSPECIES}
ACTOR MultiEniram : Eniram {+THRUSPECIES}
ACTOR MultiEniramBoss : EniramBoss {+THRUSPECIES}
ACTOR MultiTymok : Tymok {+THRUSPECIES}
ACTOR MultiSemaj : Semaj {+THRUSPECIES}
ACTOR MultiTenaj : Tenaj {+THRUSPECIES}
ACTOR MultiNerraw : Nerraw {+THRUSPECIES}
ACTOR MultiTebazile : Tebazile {+THRUSPECIES}

// Blood

ACTOR MultiAxeZombie : AxeZombie {+THRUSPECIES}
ACTOR MultiButcher : Butcher {+THRUSPECIES}
ACTOR MultiGillBeast : GillBeast {+THRUSPECIES}
ACTOR MultiBloodBeast : BloodBeast {+THRUSPECIES}
ACTOR MultiBloodPhantasm : BloodPhantasm {+THRUSPECIES}
ACTOR MultiTchernobog : Tchernobog {+THRUSPECIES}
ACTOR MultiCultist : Cultist {+THRUSPECIES}
ACTOR MultiFanatic : Fanatic {+THRUSPECIES}
ACTOR MultiBloodAcolyte : BloodAcolyte {+THRUSPECIES}
ACTOR MultiZealot : Zealot {+THRUSPECIES}
ACTOR MultiBloodPriest : BloodPriest {+THRUSPECIES}
ACTOR MultiBloodGargoyle : BloodGargoyle {+THRUSPECIES}
ACTOR MultiHellHound : HellHound {+THRUSPECIES}
ACTOR MultiMotherSpider : MotherSpider {+THRUSPECIES}
ACTOR MultiBloodSpider1 : BloodSpider1 {+THRUSPECIES}
ACTOR MultiBloodSpider2 : BloodSpider2 {+THRUSPECIES}
ACTOR MultiCerberus : Cerberus {+THRUSPECIES}
ACTOR MultiCheogh : Cheogh {+THRUSPECIES}
ACTOR MultiBloodBat : BloodBat {+THRUSPECIES}

// Marathon

ACTOR MultiMWasp : MWasp { Species "Enemies" +THRUSPECIES }
ACTOR MultiMADD1 : MADD1 { Species "Enemies" +THRUSPECIES }
ACTOR MultiMLooker : MLooker { Species "Enemies" +THRUSPECIES }

// Rebel Moon Rising

ACTOR MultiUNBluesuit : UNBluesuit {+THRUSPECIES}
ACTOR MultiUnShockTrooper : UnShockTrooper {+THRUSPECIES}
ACTOR MultiUNJTrooper : UNJTrooper {+THRUSPECIES}
ACTOR MultiRMRLaserDrone : RMRLaserDrone {+THRUSPECIES}
ACTOR MultiRMRGrenadeDrone : RMRGrenadeDrone {+THRUSPECIES}
ACTOR MultiBlacksuitStriker : BlacksuitStriker {+THRUSPECIES}
ACTOR MultiHeavyBlacksuit : HeavyBlacksuit {+THRUSPECIES}
ACTOR MultiRMRSpinner : RMRSpinner {+THRUSPECIES}
ACTOR MultiRMRShoggran : RMRShoggran {+THRUSPECIES}
ACTOR MultiSubestronBoss : SubestronBoss {+THRUSPECIES}
ACTOR MultiRMREstronBig : RMREstronBig {+THRUSPECIES}
ACTOR MultiBigEstronBeast : BigEstronBeast {+THRUSPECIES}
ACTOR MultiBabyEstronBeast : BabyEstronBeast {+THRUSPECIES}
ACTOR MultiRMRLDFRegular : RMRLDFRegular {+THRUSPECIES}
ACTOR MultiRMRLDFMilita : RMRLDFMilita {+THRUSPECIES}
ACTOR MultiRMRJCommando : RMRJCommando {+THRUSPECIES}
ACTOR MultiTerranCommando : TerranCommando {+THRUSPECIES}
ACTOR MultiRMRHoverGunner : RMRHoverGunner {+THRUSPECIES}

// Exhumed

ACTOR MultiRedMite : RedMite {+THRUSPECIES}
ACTOR MultiBlueScorpion : BlueScorpion {+THRUSPECIES}
ACTOR MultiExHawk : ExHawk {+THRUSPECIES}
ACTOR MultiAnubisWarrior : AnubisWarrior {+THRUSPECIES}
ACTOR MultiBastet : Bastet {+THRUSPECIES}
ACTOR MultiExMummy : ExMummy {+THRUSPECIES}
ACTOR MultiOmenWasp : OmenWasp {+THRUSPECIES}
ACTOR MultiKilmaatSentry : KilmaatSentry {+THRUSPECIES}
ACTOR MultiOmenWaspNecro : OmenWaspNecro {+THRUSPECIES}
ACTOR MultiAmmit : Ammit {+THRUSPECIES}
ACTOR MultiMagmantis : Magmantis {+THRUSPECIES}
ACTOR MultiPSSet : PSSet {+THRUSPECIES}
ACTOR MultiSelkis : Selkis {+THRUSPECIES}
ACTOR MultiKilmaatikahn : Kilmaatikahn {+THRUSPECIES}

// In Pursuit of Greed

ACTOR MultiIPOGPrisoner : IPOGPrisoner {+THRUSPECIES}
ACTOR MultiIPOGTrooper : IPOGTrooper {+THRUSPECIES}
ACTOR MultiIPOGGuard : IPOGGuard {+THRUSPECIES}
ACTOR MultiIPOGBigGuard : IPOGBigGuard {+THRUSPECIES}
ACTOR MultiIPOGSentinal : IPOGSentinal {+THRUSPECIES}
ACTOR MultiIPOGBerserker : IPOGBerserker {+THRUSPECIES}
ACTOR MultiIPOGPriestess : IPOGPriestess {+THRUSPECIES}
ACTOR MultiIPOGVeekWarrior : IPOGVeekWarrior {+THRUSPECIES}
ACTOR MultiIPOGWizard : IPOGWizard {+THRUSPECIES}
ACTOR MultiIPOGBrnourd : IPOGBrnourd {+THRUSPECIES}
ACTOR MultiIPOGEliteCorp : IPOGEliteCorp {+THRUSPECIES}
ACTOR MultiIPOGHuntress : IPOGHuntress {+THRUSPECIES}
ACTOR MultiIPOGSentrySphere : IPOGSentrySphere {+THRUSPECIES}
ACTOR MultiIPOGSentrySphere0 : IPOGSentrySphere0 {+THRUSPECIES}
ACTOR MultiIPOGMastiff : IPOGMastiff {+THRUSPECIES}
ACTOR MultiIPOGChancellor : IPOGChancellor {+THRUSPECIES}
ACTOR MultiIPOGBighead : IPOGBighead {+THRUSPECIES}

// Witchaven

ACTOR MultiWTSkeleton : WTSkeleton {+THRUSPECIES}
ACTOR MultiForestGoblin : ForestGoblin {+THRUSPECIES}
ACTOR MultiMountainGoblin : MountainGoblin {+THRUSPECIES}
ACTOR MultiDesertGoblin : DesertGoblin {+THRUSPECIES}
ACTOR MultiBrownOgre : BrownOgre {+THRUSPECIES}
ACTOR MultiGreenOgre : GreenOgre {+THRUSPECIES}
ACTOR MultiRedOgre : RedOgre {+THRUSPECIES}
ACTOR MultiWitchavenBrute : WitchavenBrute {+THRUSPECIES}
ACTOR MultiWTGreyWitch : WTGreyWitch {+THRUSPECIES}
ACTOR MultiWitchavenIMP : WitchavenIMP {+THRUSPECIES}
ACTOR MultiWTSkeletalPriestess : WTSkeletalPriestess {+THRUSPECIES}
ACTOR MultiWitchavenShadowHound : WitchavenShadowHound {+THRUSPECIES}
ACTOR MultiWitchavenDragon : WitchavenDragon {+THRUSPECIES}
ACTOR MultiWitchavenSpider : WitchavenSpider {+THRUSPECIES}
ACTOR MultiWTWillOWisp : WTWillOWisp {+THRUSPECIES}
ACTOR MultiWitchaven1Guardian : Witchaven1Guardian {+THRUSPECIES}
ACTOR MultiWitchaven2Guardian : Witchaven2Guardian {+THRUSPECIES}
ACTOR MultiWitchavenScaryScreamer : WitchavenScaryScreamer {+THRUSPECIES}
ACTOR MultiWTRedMidianWarriorHalberd : WTRedMidianWarriorHalberd {+THRUSPECIES}
ACTOR MultiWTRedMidianWarriorSword : WTRedMidianWarriorSword {+THRUSPECIES}
ACTOR MultiWTBrownMidianWarriorHalberd : WTBrownMidianWarriorHalberd {+THRUSPECIES}
ACTOR MultiWTBrownMidianWarriorSword : WTBrownMidianWarriorSword {+THRUSPECIES}
ACTOR MultiWTBlueMidianWarriorHalberd : WTBlueMidianWarriorHalberd {+THRUSPECIES}
ACTOR MultiWTBlueMidianWarriorSword : WTBlueMidianWarriorSword {+THRUSPECIES}
ACTOR MultiWTPurpleMidianWarriorHalberd : WTPurpleMidianWarriorHalberd {+THRUSPECIES}
ACTOR MultiWTPurpleMidianWarriorSword : WTPurpleMidianWarriorSword {+THRUSPECIES}
ACTOR MultiMinoDrake : MinoDrake {+THRUSPECIES}
ACTOR MultiWTArgothonianFist : WTArgothonianFist {+THRUSPECIES}
ACTOR MultiWTArgothonianPikeAxe : WTArgothonianPikeAxe {+THRUSPECIES}
ACTOR MultiWTArgothonianSword : WTArgothonianSword {+THRUSPECIES}
ACTOR MultiWTArgothonianPikeAxeSword : WTArgothonianPikeAxeSword {+THRUSPECIES}
ACTOR MultiWTArgothonianPikeAxeFist : WTArgothonianPikeAxeFist {+THRUSPECIES}
ACTOR MultiWTArgothonianPikeAxe_2 : WTArgothonianPikeAxe_2 {+THRUSPECIES}
ACTOR MultiWTArgothonianPikeAxe_3 : WTArgothonianPikeAxe_3 {+THRUSPECIES}
ACTOR MultiWTGiryonKnight2HSword : WTGiryonKnight2HSword {+THRUSPECIES}
ACTOR MultiWTGiryonKnight1HSword : WTGiryonKnight1HSword {+THRUSPECIES}
ACTOR MultiWTGiryonKnightMace : WTGiryonKnightMace {+THRUSPECIES}
ACTOR MultiWTCiraenSentinelBow : WTCiraenSentinelBow {+THRUSPECIES}
ACTOR MultiWTCiraenSentinelFists : WTCiraenSentinelFists {+THRUSPECIES}
ACTOR MultiWTCiraenSentinelMorningStar : WTCiraenSentinelMorningStar {+THRUSPECIES}
ACTOR MultiWTCiraenSentinelBowAndStar : WTCiraenSentinelBowAndStar {+THRUSPECIES}
ACTOR MultiWTCiraenSentinelSpell : WTCiraenSentinelSpell {+THRUSPECIES}
ACTOR MultiWTCiraenSentinelSpellAndStar : WTCiraenSentinelSpellAndStar {+THRUSPECIES}
ACTOR MultiWTCiraenSentinelSpell_2 : WTCiraenSentinelSpell_2 {+THRUSPECIES}
ACTOR MultiWTCiraenSentinelBow_2 : WTCiraenSentinelBow_2 {+THRUSPECIES}
ACTOR MultiWTCiraenSentinelBowAndStar_2 : WTCiraenSentinelBowAndStar_2 {+THRUSPECIES}
ACTOR MultiWTCiraenSentinelSpellAndStar_2 : WTCiraenSentinelSpellAndStar_2 {+THRUSPECIES}
ACTOR MultiWTCiraeArgoth : WTCiraeArgoth {+THRUSPECIES}
ACTOR MultiWTIllwhyrin : WTIllwhyrin {+THRUSPECIES}
ACTOR MultiWTLavaFiend : WTLavaFiend {+THRUSPECIES}
ACTOR MultiWTMuckDemoness : WTMuckDemoness {+THRUSPECIES}

// Duke Nukem

Actor MultiZombiePigCop : ZombiePigCop { Species "Enemies" +THRUSPECIES }
Actor MultiPigInaDress : PigInaDress { Species "Enemies" +THRUSPECIES }
Actor MultiSharkDrone : SharkDrone { Species "Enemies" +THRUSPECIES }
Actor MultiAssaultGeneral : AssaultGeneral { Species "Enemies" +THRUSPECIES }

// Half Life
Actor MultiHeadcrab : Headcrab { +THRUSPECIES }
Actor MultiHeadcrab_Scientist : Headcrab_Scientist { +THRUSPECIES }
Actor MultiHeadcrab_Barney : Headcrab_Barney { +THRUSPECIES }
Actor MultiHeadcrab_Soldier : Headcrab_Soldier { +THRUSPECIES }
Actor MultiHECU_Grunt1 : HECU_Grunt1 { +THRUSPECIES }
Actor MultiHECU_Grunt2 : HECU_Grunt2 { +THRUSPECIES }
Actor MultiHECU_Shotgun1 : HECU_Shotgun1 { +THRUSPECIES }
Actor MultiHECU_Shotgun2 : HECU_Shotgun2 { +THRUSPECIES }
Actor MultiHECU_M203 : HECU_M203 { +THRUSPECIES }
Actor MultiHECU_Commander1 : HECU_Commander1 { +THRUSPECIES }
Actor MultiHECU_Commander2 : HECU_Commander2 { +THRUSPECIES }
Actor MultiHECU_Grunt : RandomSpawner
{
	DropItem "MultiHECU_Grunt1", 255, 4
	DropItem "MultiHECU_Grunt2", 255, 4
	DropItem "MultiHECU_Shotgun1", 255, 3
	DropItem "MultiHECU_Shotgun2", 255, 3
	DropItem "MultiHECU_M203", 255, 2
	DropItem "MultiHECU_Commander1", 255, 1
	DropItem "MultiHECU_Commander2", 255, 1
}
Actor MultiHECU_Grunt1_Opp_MP5 : HECU_Grunt1_Opp_MP5 { +THRUSPECIES }
Actor MultiHECU_Grunt2_Opp_MP5 : HECU_Grunt2_Opp_MP5 { +THRUSPECIES }
Actor MultiHECU_Grunt1_Opp_Shotgun : HECU_Grunt1_Opp_Shotgun { +THRUSPECIES }
Actor MultiHECU_Grunt2_Opp_Shotgun : HECU_Grunt2_Opp_Shotgun { +THRUSPECIES }
Actor MultiHECU_Shotgunner1_Opp_MP5 : HECU_Shotgunner1_Opp_MP5 { +THRUSPECIES }
Actor MultiHECU_Shotgunner2_Opp_MP5 : HECU_Shotgunner2_Opp_MP5 { +THRUSPECIES }
Actor MultiHECU_Shotgunner1_Opp_Shotgun : HECU_Shotgunner1_Opp_Shotgun { +THRUSPECIES }
Actor MultiHECU_Shotgunner2_Opp_Shotgun : HECU_Shotgunner2_Opp_Shotgun { +THRUSPECIES }
Actor MultiHECU_Mask_Opp_MP5 : HECU_Mask_Opp_MP5 { +THRUSPECIES }
Actor MultiHECU_Mask_Opp_Shotgun : HECU_Mask_Opp_Shotgun { +THRUSPECIES }
Actor MultiHECU_Commander1_Opp_MP5 : HECU_Commander1_Opp_MP5 { +THRUSPECIES }
Actor MultiHECU_Commander2_Opp_MP5 : HECU_Commander2_Opp_MP5 { +THRUSPECIES }
Actor MultiHECU_Commander1_Opp_Shotgun : HECU_Commander1_Opp_Shotgun { +THRUSPECIES }
Actor MultiHECU_Commander2_Opp_Shotgun : HECU_Commander2_Opp_Shotgun { +THRUSPECIES }
Actor MultiHECU_Major_Opp_MP5 : HECU_Major_Opp_MP5 { +THRUSPECIES }
Actor MultiHECU_Major_Opp_Shotgun : HECU_Major_Opp_Shotgun { +THRUSPECIES }
Actor MultiHECU_Grunt_Opp_Small : RandomSpawner
{
	DropItem "MultiHECU_Grunt1_Opp_MP5", 255, 10
	DropItem "MultiHECU_Grunt2_Opp_MP5", 255, 10
	DropItem "MultiHECU_Grunt1_Opp_Shotgun", 255, 5
	DropItem "MultiHECU_Grunt2_Opp_Shotgun", 255, 5
	DropItem "MultiHECU_Shotgunner1_Opp_MP5", 255, 6
	DropItem "MultiHECU_Shotgunner2_Opp_MP5", 255, 6
	DropItem "MultiHECU_Shotgunner1_Opp_Shotgun", 255, 3
	DropItem "MultiHECU_Shotgunner2_Opp_Shotgun", 255, 3
	DropItem "MultiHECU_Mask_Opp_MP5", 255, 8
	DropItem "MultiHECU_Mask_Opp_Shotgun", 255, 4
	DropItem "MultiHECU_Commander1_Opp_MP5", 255, 3
	DropItem "MultiHECU_Commander2_Opp_MP5", 255, 3
	DropItem "MultiHECU_Commander1_Opp_Shotgun", 255, 2
	DropItem "MultiHECU_Commander2_Opp_Shotgun", 255, 2
	DropItem "MultiHECU_Major_Opp_MP5", 255, 1
	DropItem "MultiHECU_Major_Opp_Shotgun", 255, 1
}
Actor MultiHECU_Grunt1_Opp_Saw : HECU_Grunt1_Opp_Saw { +THRUSPECIES }
Actor MultiHECU_Grunt2_Opp_Saw : HECU_Grunt2_Opp_Saw { +THRUSPECIES }
Actor MultiHECU_Shotgunner1_Opp_Saw : HECU_Shotgunner1_Opp_Saw { +THRUSPECIES }
Actor MultiHECU_Shotgunner2_Opp_Saw : HECU_Shotgunner2_Opp_Saw { +THRUSPECIES }
Actor MultiHECU_Mask_Opp_Saw : HECU_Mask_Opp_Saw { +THRUSPECIES }
Actor MultiHECU_Commander1_Opp_Saw : HECU_Commander1_Opp_Saw { +THRUSPECIES }
Actor MultiHECU_Commander2_Opp_Saw : HECU_Commander2_Opp_Saw { +THRUSPECIES }
Actor MultiHECU_Major_Opp_Saw : HECU_Major_Opp_Saw { +THRUSPECIES }
Actor MultiHECU_Grunt_Opp_MG : RandomSpawner 
{
	DropItem "MultiHECU_Grunt1_Opp_Saw", 255, 10
	DropItem "MultiHECU_Grunt2_Opp_Saw", 255, 10
	DropItem "MultiHECU_Shotgunner1_Opp_Saw", 255, 6
	DropItem "MultiHECU_Shotgunner2_Opp_Saw", 255, 6
	DropItem "MultiHECU_Mask_Opp_Saw", 255, 8
	DropItem "MultiHECU_Commander1_Opp_Saw", 255, 3
	DropItem "MultiHECU_Commander2_Opp_Saw", 255, 3
	DropItem "MultiHECU_Major_Opp_Saw", 255, 1
}
Actor MultiHECU_Grunt1_StayOpp_MP5 : HECU_Grunt1_StayOpp_MP5 { +THRUSPECIES }
Actor MultiHECU_Grunt2_StayOpp_MP5 : HECU_Grunt2_StayOpp_MP5 { +THRUSPECIES }
Actor MultiHECU_Grunt1_StayOpp_Shotgun : HECU_Grunt1_StayOpp_Shotgun { +THRUSPECIES }
Actor MultiHECU_Grunt2_StayOpp_Shotgun : HECU_Grunt2_StayOpp_Shotgun { +THRUSPECIES }
Actor MultiHECU_Shotgunner1_StayOpp_MP5 : HECU_Shotgunner1_StayOpp_MP5 { +THRUSPECIES }
Actor MultiHECU_Shotgunner2_StayOpp_MP5 : HECU_Shotgunner2_StayOpp_MP5 { +THRUSPECIES }
Actor MultiHECU_Shotgunner1_StayOpp_Shotgun : HECU_Shotgunner1_StayOpp_Shotgun { +THRUSPECIES }
Actor MultiHECU_Shotgunner2_StayOpp_Shotgun : HECU_Shotgunner2_StayOpp_Shotgun { +THRUSPECIES }
Actor MultiHECU_Mask_StayOpp_MP5 : HECU_Mask_StayOpp_MP5 { +THRUSPECIES }
Actor MultiHECU_Mask_StayOpp_Shotgun : HECU_Mask_StayOpp_Shotgun { +THRUSPECIES }
Actor MultiHECU_Commander1_StayOpp_MP5 : HECU_Commander1_StayOpp_MP5 { +THRUSPECIES }
Actor MultiHECU_Commander2_StayOpp_MP5 : HECU_Commander2_StayOpp_MP5 { +THRUSPECIES }
Actor MultiHECU_Commander1_StayOpp_Shotgun : HECU_Commander1_StayOpp_Shotgun { +THRUSPECIES }
Actor MultiHECU_Commander2_StayOpp_Shotgun : HECU_Commander2_StayOpp_Shotgun { +THRUSPECIES }
Actor MultiHECU_FGrunt_Opp_Small : RandomSpawner
{
	DropItem "MultiHECU_Grunt1_StayOpp_MP5", 255, 10
	DropItem "MultiHECU_Grunt2_StayOpp_MP5", 255, 10
	DropItem "MultiHECU_Grunt1_StayOpp_Shotgun", 255, 5
	DropItem "MultiHECU_Grunt2_StayOpp_Shotgun", 255, 5
	DropItem "MultiHECU_Shotgunner1_StayOpp_MP5", 255, 6
	DropItem "MultiHECU_Shotgunner2_StayOpp_MP5", 255, 6
	DropItem "MultiHECU_Shotgunner1_StayOpp_Shotgun", 255, 3
	DropItem "MultiHECU_Shotgunner2_StayOpp_Shotgun", 255, 3
	DropItem "MultiHECU_Mask_StayOpp_MP5", 255, 8
	DropItem "MultiHECU_Mask_StayOpp_Shotgun", 255, 4
	DropItem "MultiHECU_Commander1_StayOpp_MP5", 255, 3
	DropItem "MultiHECU_Commander2_StayOpp_MP5", 255, 3
	DropItem "MultiHECU_Commander1_StayOpp_Shotgun", 255, 2
	DropItem "MultiHECU_Commander2_StayOpp_Shotgun", 255, 2
}
Actor MultiHECU_Grunt1_StayOpp_Saw : HECU_Grunt1_StayOpp_Saw { +THRUSPECIES }
Actor MultiHECU_Grunt2_StayOpp_Saw : HECU_Grunt2_StayOpp_Saw { +THRUSPECIES }
Actor MultiHECU_Shotgunner1_StayOpp_Saw : HECU_Shotgunner1_StayOpp_Saw { +THRUSPECIES }
Actor MultiHECU_Shotgunner2_StayOpp_Saw : HECU_Shotgunner2_StayOpp_Saw { +THRUSPECIES }
Actor MultiHECU_Mask_StayOpp_Saw : HECU_Mask_StayOpp_Saw { +THRUSPECIES }
Actor MultiHECU_Commander1_StayOpp_Saw : HECU_Commander1_StayOpp_Saw { +THRUSPECIES }
Actor MultiHECU_Commander2_StayOpp_Saw : HECU_Commander2_StayOpp_Saw { +THRUSPECIES }
Actor MultiHECU_FGrunt_Opp_MG : RandomSpawner
{
	DropItem "MultiHECU_Grunt1_StayOpp_Saw", 255, 10
	DropItem "MultiHECU_Grunt2_StayOpp_Saw", 255, 10
	DropItem "MultiHECU_Shotgunner1_StayOpp_Saw", 255, 6
	DropItem "MultiHECU_Shotgunner2_StayOpp_Saw", 255, 6
	DropItem "MultiHECU_Mask_StayOpp_Saw", 255, 8
	DropItem "MultiHECU_Commander1_StayOpp_Saw", 255, 3
	DropItem "MultiHECU_Commander2_StayOpp_Saw", 255, 3
}
Actor MultiHECU_Sarge : HECU_Sarge { +THRUSPECIES }
Actor MultiGonome : Gonome { +THRUSPECIES }
Actor MultiVortigaunt : Vortigaunt { +THRUSPECIES }
Actor MultiBullSquid : Bullsquid { +THRUSPECIES }
Actor MultiMaleAssassin1_MP5 : MaleAssassin1_MP5 { +THRUSPECIES }
Actor MultiMaleAssassin2_MP5 : MaleAssassin2_MP5 { +THRUSPECIES }
Actor MultiMaleAssassin3_MP5 : MaleAssassin3_MP5 { +THRUSPECIES }
Actor MultiMaleAssassin1_M40 : MaleAssassin1_M40 { +THRUSPECIES }
Actor MultiMaleAssassin2_M40 : MaleAssassin2_M40 { +THRUSPECIES }
Actor MultiMaleAssassin3_M40 : MaleAssassin3_M40 { +THRUSPECIES }
Actor MultiHLBlackopsMaleSpawner : RandomSpawner
{
	DropItem "MultiMaleAssassin1_MP5", 255, 8
	DropItem "MultiMaleAssassin2_MP5", 255, 8
	DropItem "MultiMaleAssassin3_MP5", 255, 8
	DropItem "MultiMaleAssassin1_M40", 255, 4
	DropItem "MultiMaleAssassin2_M40", 255, 4
	DropItem "MultiMaleAssassin3_M40", 255, 4
}
Actor MultiHLAssassin : HLAssassin { +THRUSPECIES }
Actor MultiHLAssassin_Opp : HLAssassin_Opp { +THRUSPECIES }
Actor MultiHLBlackOpsFemaleSpawner : RandomSpawner
{
	DropItem "MultiHLAssassin"
	DropItem "MultiHLAssassin_Opp"
}
Actor MultiHLController : HLController { +THRUSPECIES }
Actor MultiAlienGrunt : AlienGrunt { +THRUSPECIES }
Actor MultiShocktrooper : Shocktrooper { +THRUSPECIES }
Actor MultiHECU_Apache : HECU_Apache { +THRUSPECIES }
Actor MultiGargantua : Gargantua { +THRUSPECIES }
Actor MultiHLHoundeye : HLHoundeye { +THRUSPECIES }
Actor MultiVoltigore : Voltigore { +THRUSPECIES }
Actor MultiHLPitdrone : HLPitdrone { +THRUSPECIES }
Actor MultiHLAbrams : HLAbrams { +THRUSPECIES }
Actor MultiHLBradley : HLBradley { +THRUSPECIES }
Actor MultiHLAbramsGun : HLAbramsGun { +THRUSPECIES }
Actor MultiHLBradleyGun : HLBradleyGun { +THRUSPECIES }
Actor MultiHECU_Robot1 : HECU_Robot1 { +THRUSPECIES }
Actor MultiHECU_Robot2 : HECU_Robot2 { +THRUSPECIES }
Actor MultiHECU_Apache_OPS : HECU_Apache_OPS { +THRUSPECIES }
Actor MultiBabyHeadcrab : BabyHeadcrab { +THRUSPECIES }
Actor MultiGeneworm : Geneworm { +THRUSPECIES }
Actor MultiStukabat : Stukabat { +THRUSPECIES }
Actor MultiGonarch : Gonarch { +THRUSPECIES }
Actor MultiNihilanth : Nihilanth { +THRUSPECIES }
Actor MultiHLPitworm : HLPitworm { +THRUSPECIES }
Actor MultiHLKingPin : HLKingpin { +THRUSPECIES }
Actor MultiCombine_Soldier_MP7 : Combine_Soldier_MP7 { +THRUSPECIES }
Actor MultiCombine_Soldier_MP7_Dirty : Combine_Soldier_MP7_Dirty { +THRUSPECIES }
Actor MultiCombine_Soldier_Shotgun : Combine_Soldier_Shotgun { +THRUSPECIES }
Actor MultiCombine_Soldier_Shotgun_Dirty : Combine_Soldier_Shotgun_Dirty { +THRUSPECIES }
Actor MultiCombine_Soldier_AR2 : Combine_Soldier_AR2 { +THRUSPECIES }
Actor MultiCombine_Soldier_AR2_Dirty : Combine_Soldier_AR2_Dirty { +THRUSPECIES }
Actor MultiCombine_Elite_AR2 : Combine_Elite_AR2 { +THRUSPECIES }
Actor MultiCombine_Elite_AR2_Dirty : Combine_Elite_AR2_Dirty { +THRUSPECIES }
Actor MultiCombine_Overwatch : RandomSpawner
{
	DropItem "MultiCombine_Soldier_MP7", 255, 6
	DropItem "MultiCombine_Soldier_MP7_Dirty", 255, 3
	DropItem "MultiCombine_Soldier_Shotgun", 255, 4
	DropItem "MultiCombine_Soldier_Shotgun_Dirty", 255, 2
	DropItem "MultiCombine_Soldier_AR2", 255, 3
	DropItem "MultiCombine_Soldier_AR2_Dirty", 255, 3
	DropItem "MultiCombine_Elite_AR2", 255, 3
	DropItem "MultiCombine_Elite_AR2_Dirty", 255, 3
}

//Quake 2
Actor MultiQ2LightGuard : Q2LightGuard { +THRUSPECIES }
Actor MultiQ2ShotgunGuard : Q2ShotgunGuard { +THRUSPECIES }
Actor MultiQ2MachineGunGuard : Q2MachineGunGuard { +THRUSPECIES }
Actor MultiQ2EnhancedLightGuard : Q2EnhancedLightGuard { +THRUSPECIES }
Actor MultiQ2RipperGuard : Q2RipperGuard { +THRUSPECIES }
Actor MultiQ2HyperBlasterGuard : Q2HyperBlasterGuard { +THRUSPECIES }
Actor MultiQ2LaserGuard : Q2LaserGuard { +THRUSPECIES }
Actor MultiQ2Infantry : Q2Infantry { +THRUSPECIES }
Actor MultiQ2Gunner : Q2Gunner { +THRUSPECIES }
Actor MultiQ2Berserker : Q2Berserker { +THRUSPECIES }
Actor MultiQ2Brain : Q2Brain { +THRUSPECIES }
Actor MultiQ2BrainBetaClass : Q2BrainBetaClass { +THRUSPECIES }
Actor MultiQ2Parasite : Q2Parasite { +THRUSPECIES }
Actor MultiQ2Flyer : Q2Flyer { +THRUSPECIES }
Actor MultiQ2Icarus : Q2Icarus { +THRUSPECIES }
Actor MultiQ2Daedalus : Q2Daedalus { +THRUSPECIES }
Actor MultiQ2IronMaiden : Q2IronMaiden { +THRUSPECIES }
Actor MultiQ2Gladiator : Q2Gladiator { +THRUSPECIES }
Actor MultiQ2GladiatorBetaClass : Q2GladiatorBetaClass { +THRUSPECIES }
Actor MultiQ2IronMaidenBetaClass : Q2IronMaidenBetaClass { +THRUSPECIES }
Actor MultiQ2Tank : Q2Tank { +THRUSPECIES }
Actor MultiQ2TankCommander : Q2TankCommander { +THRUSPECIES }
Actor MultiQ2Makron : Q2Makron { +THRUSPECIES }
Actor MultiQ2TankBoss : Q2TankBoss { +THRUSPECIES }
Actor MultiQ2SuperTank : Q2SuperTank { +THRUSPECIES }
Actor MultiQ2Technician : Q2Technician { +THRUSPECIES }
Actor MultiQ2Medic : Q2Medic { +THRUSPECIES }
Actor MultiQ2MedicCommander : Q2MedicCommander { +THRUSPECIES }
Actor MultiQ2Hornet : Q2Hornet { +THRUSPECIES }
Actor MultiQ2Gekk : Q2Gekk { +THRUSPECIES }
Actor MultiQ2Stalker : Q2Stalker { +THRUSPECIES }
Actor MultiQ2Widow : Q2Widow { +THRUSPECIES }
Actor MultiQ2Carrier : Q2Carrier { +THRUSPECIES }
Actor MultiQ2Mutant : Q2Mutant { +THRUSPECIES }

// Quake 1
Actor MultiQGrunt : QGrunt { +THRUSPECIES }
Actor MultiQEnforcer : QEnforcer { +THRUSPECIES }
Actor MultiQZombie : QZombie { +THRUSPECIES }
Actor MultiQOgre : QOgre { +THRUSPECIES }
Actor MultiQCentroid : QCentroid { +THRUSPECIES }
Actor MultiQKnight : QKnight { +THRUSPECIES }
Actor MultiQKStatue2 : QKStatue2 { +THRUSPECIES }
Actor MultiQGuardian2 : QGuardian2 { +THRUSPECIES }
Actor MultiQFiend : QFiend { +THRUSPECIES }
Actor MultiQGremlin : QGremlin { +THRUSPECIES }
Actor MultiQGuardian : QGuardian { +THRUSPECIES }
Actor MultiQuake_HellSpawn : Quake_HellSpawn { +THRUSPECIES }
Actor MultiQuake_HellSpawn_2 : Quake_HellSpawn_2 { +THRUSPECIES }
Actor MultiQGuardian3 : QGuardian3 { +THRUSPECIES }
Actor MultiQKStatue1 : QKStatue1 { +THRUSPECIES }
Actor MultiQMultiOgre : QMultiOgre { +THRUSPECIES }
Actor MultiQPhantomSwordsman : QPhantomSwordsman { +THRUSPECIES }
Actor MultiQHKnight : QHKnight { +THRUSPECIES }
Actor MultiQMummy : QMummy { +THRUSPECIES }
Actor MultiQGuardian4 : QGuardian4 { +THRUSPECIES }
Actor MultiRottweiler : Rottweiler { +THRUSPECIES }
Actor MultiQScrag : QScrag { +THRUSPECIES }
Actor MultiShambler : Shambler { +THRUSPECIES }
Actor MultiQuake_Spawn : Quake_Spawn { +THRUSPECIES } 
Actor MultiQSpikeMine : QSpikeMine { +THRUSPECIES }
Actor MultiVore : Vore { +THRUSPECIES }
Actor MultiQWrath : QWrath { +THRUSPECIES }
Actor MultiQOverlord : QOverlord { +THRUSPECIES }
Actor MultiQArmagon : QArmagon { +THRUSPECIES }
Actor MultiPterodactylus : Pterodactylus { +THRUSPECIES }
Actor MultiShub-Niggurath : Shub-Niggurath { +THRUSPECIES }

// Disruptor
Actor MultiDisruptorAcidBloater : DisruptorAcidBloater { +THRUSPECIES }
Actor MultiDisruptorAGuardian : DisruptorAGuardian { +THRUSPECIES }
Actor MultiAlienWanderer_T1 : AlienWanderer_T1 { +THRUSPECIES }
Actor MultiAlienWanderer_T2 : AlienWanderer_T2 { +THRUSPECIES }
Actor MultiDisruptorCryopirate : DisruptorCryopirate { +THRUSPECIES }
Actor MultiDisruptorNDisruptor : DisruptorNDisruptor { +THRUSPECIES }
Actor MultiDS_Flying_Droid : DS_Flying_Droid { +THRUSPECIES }
Actor MultiDisruptorGuardDroid : DisruptorGuardDroid { +THRUSPECIES }
Actor MultiDisruptorHostageDroid : DisruptorHostageDroid { +THRUSPECIES }
Actor MultiDisruptorMBrute : DisruptorMBrute { +THRUSPECIES }
Actor MultiDisruptorDragonFly : DisruptorDragonFly { +THRUSPECIES }
Actor MultiDisruptorMutantElite : DisruptorMutantElite { +THRUSPECIES }
Actor MultiDisruptorMRat : DisruptorMRat { +THRUSPECIES }
Actor MultiDisruptorMutantSoldier : DisruptorMutantSoldier { +THRUSPECIES }
Actor MultiNightmare_Demon : Nightmare_Demon { +THRUSPECIES }
Actor MultiDisruptorNightmareSphere : DisruptorNightmareSphere { +THRUSPECIES }
Actor MulitDisruptorNightmareSpider : DisruptorNightmareSpider { +THRUSPECIES }
Actor MultiDsrptSawRobot : DsrptSawRobot { +THRUSPECIES }
Actor MultiDsrptSilverSpikeBall : DsrptSilverSpikeBall { +THRUSPECIES }
Actor MultiDsrptGoldSpikeBall : DsrptGoldSpikeBall { +THRUSPECIES }
Actor MultiDsrptPsionicSpikeBall : DsrptPsionicSpikeBall { +THRUSPECIES }
Actor MultiDisruptorTerroristCyclone : DisruptorTerroristCyclone { +THRUSPECIES }
Actor MultiDisruptorTerroristDroid : DisruptorTerroristDroid { +THRUSPECIES }
Actor MultiDisruptorTerroristDroid2 : DisruptorTerroristDroid2 { +THRUSPECIES }
Actor MultiDisruptorTerroristElite : DisruptorTerroristElite { +THRUSPECIES }
Actor MultiDisruptorTerroristRepeater : DisruptorTerroristRepeater { +THRUSPECIES }
Actor MultiDS_PresidentK : DS_PresidentK { +THRUSPECIES }